Second line: #rows, #columns #jewels. Other lines: H-horizontal path, V-vertical path, C-cross path, W-wall, S-starting point, J-jewel
15 15 20 10
W H H H H H C H H C H C W W J
W J W J W C C W C C W V W C C
W V H V C C J W V V W C H V W
W C H C C W V C V H W V H V V
W W W C J W S C C C W C H V V
J H H H H H C W C W W C H C H
W V C V C W V H H W C H H W W
J W W W W W V W V W V W W C J
V C C C W W C C C H H H W C W
C C W C C W V W C C C J W V C
C C W W C C C C W W J H H V C
C H W J W H V H H W W V W V C
V J J V J J V H C H C C C C W
V J J V J J V H C W V W W C W
C H H C W H C H C H H H J C C